быстрый - скорый
красивый - прекрасный
большой - огромный
грустный - печальный
веселый - радостный
умный - сообразительный
глупый - тупой
сильный - мощный
слабый - хилый
хороший - отличный
плохой - ужасный
теплый - жаркий
холодный - ледяной
светлый - яркий
великолепный - красивый
темный - мрачный
чистый - опрятный
грязный - чумазый
свежий - новый
старый - древний
молодой - юный
злой - сердитый
красивый - обворожительный
добрый - мягкосердечный
громкий - шумный
тихий - бесшумный
высокий - рослый
низкий - маленький
длинный - протяженный
короткий - краткий
широкий - просторный
восхитительный - красивый
узкий - тесный
глубокий - бездонный
мелкий - неглубокий
твердый - жесткий
мягкий - нежный
сладкий - сахарный
горький - противный
кислый - прокисший
соленый - пересоленный
острый - колкий
тупой - затупленный
дорогой - ценный
дешевый - бюджетный
богатый - состоятельный
бедный - нищий
смелый - храбрый
трусливый - боязливый
честный - правдивый
лживый - обманчивый
интересный - увлекательный
скучный - нудный
любимый - дорогой
ненавистный - противный
родной - близкий
чужой - посторонний
свой - личный
общий - совместный
разный - различный
одинаковый - похожий
целый - полный
частичный - неполный
открытый - искренний
закрытый - скрытный
простой - легкий
сложный - трудный
понятный - ясный
непонятный - запутанный
нужный - необходимый
бесполезный - ненужный
полезный - благотворный
вредный - опасный
красный - алый
синий - голубой
зеленый - изумрудный
желтый - золотистый
черный - темный
белый - снежный
серый - серебристый
коричневый - карий
фиолетовый - лиловый
розовый - нежно-розовый
оранжевый - апельсиновый
главный - основной
второстепенный - дополнительный
первый - начальный
последний - конечный
утренний - рассветный
вечерний - сумеречный
дневной - полуденный
ночной - полуночный
летний - знойный
зимний - морозный
весенний - цветущий
осенний - дождливый
городской - урбанистический
деревенский - сельский
домашний - уютный
дикий - необузданный
ручной - прирученный
собачий - песий
кошачий - кошачий
птичий - пернатый
рыбный - рыбий
водный - водянистый
земной - наземный
воздушный - небесный
огненный - пламенный
ледяной - холодный
каменный - твердый
деревянный - древесный
железный - металлический
стеклянный - хрустальный
бумажный - картонный
шелковый - шелковистый
шерстяной - вязаный
хлопковый - хлопчатобумажный
резиновый - эластичный
пластиковый - пластмассовый
круглый - шарообразный
квадратный - четырехугольный
треугольный - трехугольный
прямой - ровный
кривой - изогнутый
ровный - гладкий
неровный - шероховатый
тонкий - худой
толстый - полный
полный - заполненный
пустой - порожний
влажный - мокрый
сухой - высохший
горячий - обжигающий
холодный - студеный
здоровый - крепкий
больной - нездоровый
сытый - накормленный
голодный - голодающий
пьяный - нетрезвый
трезвый - непьющий
босой - разутый
одетый - облаченный
раздетый - обнаженный
богатый - роскошный
бедный - убогий
щедрый - великодушный
жадный - скупой
вежливый - учтивый
грубый - неотесанный
ласковый - нежный
суровый - строгий
спокойный - уравновешенный
нервный - беспокойный
шумный - громкий
тихий - безмолвный
болтливый - говорливый
молчаливый - неразговорчивый
обидчивый - ранимый
необидчивый - терпеливый
капризный - привередливый
неприхотливый - нетребовательный
трудолюбивый - работящий
ленивый - бездельник
аккуратный - опрятный
неряшливый - неаккуратный
талантливый - одаренный
бездарный - бесталанный
известный - знаменитый
неизвестный - безвестный
популярный - модный
непопулярный - забытый
божественный - небесный
дьявольский - сатанинский
святой - праведный
грешный - порочный
ангельский - невинный
демонический - злобный
райский - блаженный
адский - ужасный
волшебный - сказочный
реальный - настоящий
вымышленный - фантастический
обычный - заурядный
необычный - удивительный
странный - чудной
нормальный - обыкновенный
чудовищный - страшный
прекрасный - великолепный
ужасный - отвратительный
восхитительный - обворожительный
мерзкий - гадкий
любопытный - любознательный
безразличный - равнодушный
внимательный - заботливый
рассеянный - невнимательный
памятный - незабываемый
забывчивый - беспамятный
радостный - счастливый
горестный - скорбный
восторженный - вдохновенный
разочарованный - огорченный
уверенный - самоуверенный
сомневающийся - неуверенный
решительный - смелый
нерешительный - колебающийся
гордый - надменный
скромный - застенчивый
общительный - коммуникабельный
замкнутый - необщительный
доверчивый - наивный
подозрительный - недоверчивый
обильный - богатый
скудный - мизерный
дружный - сплоченный
враждебный - недружелюбный
родственный - близкий
чуждый - далекий
понятливый - сообразительный
тугодумный - медлительный
быстроногий - резвый
медлительный - неторопливый
везучий - удачливый
невезучий - неудачливый